genes	list
VIP	Tumor-adjacent Normal
CYR61	Tumor-adjacent Normal
FOS	Tumor-adjacent Normal
EGR1	Tumor-adjacent Normal
ADAMTS1	Tumor-adjacent Normal
APOLD1	Tumor-adjacent Normal
SFRP2	Tumor-adjacent Normal
DYNC1H1	Tumor-adjacent Normal
KLF2	Tumor-adjacent Normal
SFRP1	Tumor-adjacent Normal
CD248	Tumor-adjacent Normal
CTGF	Tumor-adjacent Normal
MGP	Tumor-adjacent Normal
GREM1	Tumor-adjacent Normal
RSPO3	Tumor-adjacent Normal
TNXA	Tumor-adjacent Normal
FAM107A	Tumor-adjacent Normal
AEBP1	Tumor-adjacent Normal
TNXB	Tumor-adjacent Normal
OGN	Tumor-adjacent Normal
MFAP5	Tumor-adjacent Normal
CH25H	Tumor-adjacent Normal
TIMP3	Tumor-adjacent Normal
FBLN2	Tumor-adjacent Normal
NNMT	Tumor-adjacent Normal
C3	Tumor-adjacent Normal
FLRT2	Tumor-adjacent Normal
C8orf4	Tumor-adjacent Normal
PTGIS	Tumor-adjacent Normal
CDH5	Tumor-adjacent Normal
EFHD1	Tumor-adjacent Normal
SPTBN1	Tumor-adjacent Normal
MRC2	Tumor-adjacent Normal
RERGL	Tumor-adjacent Normal
IGFBP6	Tumor-adjacent Normal
GAL	Tumor-adjacent Normal
VWF	Tumor-adjacent Normal
C11orf96	Tumor-adjacent Normal
EBF1	Tumor-adjacent Normal
CILP	Tumor-adjacent Normal
COL6A3	Tumor-adjacent Normal
C1R	Tumor-adjacent Normal
SLIT3	Tumor-adjacent Normal
ADH1B	Tumor-adjacent Normal
TGFBR3	Tumor-adjacent Normal
DUSP1	Tumor-adjacent Normal
WISP2	Tumor-adjacent Normal
LYVE1	Tumor-adjacent Normal
CCDC80	Tumor-adjacent Normal
SIK1	Tumor-adjacent Normal
THBD	Tumor-adjacent Normal
HTRA1	Tumor-adjacent Normal
TSC22D3	Tumor-adjacent Normal
HEG1	Tumor-adjacent Normal
PCSK5	Tumor-adjacent Normal
JUN	Tumor-adjacent Normal
PDGFRA	Tumor-adjacent Normal
SEMA3G	Tumor-adjacent Normal
ROBO4	Tumor-adjacent Normal
CLEC3B	Tumor-adjacent Normal
ELN	Tumor-adjacent Normal
TMEM110-MUSTN1	Tumor-adjacent Normal
MUSTN1	Tumor-adjacent Normal
PECAM1	Tumor-adjacent Normal
ZFP36	Tumor-adjacent Normal
CLDN11	Tumor-adjacent Normal
CHRDL1	Tumor-adjacent Normal
C2orf40	Tumor-adjacent Normal
SRP19	Tumor-adjacent Normal
PDGFRB	Tumor-adjacent Normal
TEK	Tumor-adjacent Normal
RBMS3	Tumor-adjacent Normal
VEGFC	Tumor-adjacent Normal
UCHL1	Tumor-adjacent Normal
PCOLCE2	Tumor-adjacent Normal
SRPX	Tumor-adjacent Normal
CD93	Tumor-adjacent Normal
FBLN1	Tumor-adjacent Normal
S1PR1	Tumor-adjacent Normal
COL14A1	Tumor-adjacent Normal
GPR116	Tumor-adjacent Normal
IGF2	Tumor-adjacent Normal
APOD	Tumor-adjacent Normal
DUSP6	Tumor-adjacent Normal
NR4A1	Tumor-adjacent Normal
CCDC3	Tumor-adjacent Normal
SOX18	Tumor-adjacent Normal
RCAN2	Tumor-adjacent Normal
OLFM1	Tumor-adjacent Normal
CEBPD	Tumor-adjacent Normal
TMTC1	Tumor-adjacent Normal
GJA1	Tumor-adjacent Normal
SHANK3	Tumor-adjacent Normal
ECSCR	Tumor-adjacent Normal
RGS1	Tumor-adjacent Normal
TMEM100	Tumor-adjacent Normal
PMP22	Tumor-adjacent Normal
APCDD1	Tumor-adjacent Normal
CLU	Tumor-adjacent Normal
MMP2	Tumor-adjacent Normal
PCDHGC5	Tumor-adjacent Normal
PCDHGB4	Tumor-adjacent Normal
MMRN1	Tumor-adjacent Normal
CACHD1	Tumor-adjacent Normal
AIF1L	Tumor-adjacent Normal
PTPRM	Tumor-adjacent Normal
LDB2	Tumor-adjacent Normal
STEAP4	Tumor-adjacent Normal
PRRX1	Tumor-adjacent Normal
EFEMP1	Tumor-adjacent Normal
ACKR3	Tumor-adjacent Normal
FBN1	Tumor-adjacent Normal
GPR124	Tumor-adjacent Normal
LRRC32	Tumor-adjacent Normal
RGMA	Tumor-adjacent Normal
TFPI	Tumor-adjacent Normal
ARHGAP29	Tumor-adjacent Normal
ZFPM2	Tumor-adjacent Normal
FKBP10	Tumor-adjacent Normal
ZBTB20	Tumor-adjacent Normal
CALB2	Tumor-adjacent Normal
ABI3BP	Tumor-adjacent Normal
CLEC14A	Tumor-adjacent Normal
SERPING1	Tumor-adjacent Normal
SHISA3	Tumor-adjacent Normal
C7	Tumor-adjacent Normal
SOD3	Tumor-adjacent Normal
MAP1B	Tumor-adjacent Normal
BCAT1	Tumor-adjacent Normal
C1S	Tumor-adjacent Normal
L1CAM	Tumor-adjacent Normal
DPT	Tumor-adjacent Normal
CSRNP1	Tumor-adjacent Normal
TAC1	Tumor-adjacent Normal
FSTL1	Tumor-adjacent Normal
FZD4	Tumor-adjacent Normal
FN1	Tumor-adjacent Normal
HSPG2	Tumor-adjacent Normal
MALAT1	Tumor-adjacent Normal
USP13	Tumor-adjacent Normal
IGFBP5	Tumor-adjacent Normal
CLDN5	Tumor-adjacent Normal
SLMAP	Tumor-adjacent Normal
ANK2	Tumor-adjacent Normal
RELN	Tumor-adjacent Normal
TMEM158	Tumor-adjacent Normal
SASH1	Tumor-adjacent Normal
COL12A1	Tumor-adjacent Normal
CSRP2	Tumor-adjacent Normal
THBS2	Tumor-adjacent Normal
PXDN	Tumor-adjacent Normal
MXRA5	Tumor-adjacent Normal
LAMC1	Tumor-adjacent Normal
PRIMA1	Tumor-adjacent Normal
GAP43	Tumor-adjacent Normal
LTBP1	Tumor-adjacent Normal
TENC1	Tumor-adjacent Normal
THBS1	Tumor-adjacent Normal
KRT24	Tumor-adjacent Normal
C16orf89	Tumor-adjacent Normal
PDE2A	Tumor-adjacent Normal
PI16	Tumor-adjacent Normal
STAB1	Tumor-adjacent Normal
RGS2	Tumor-adjacent Normal
ANGPTL2	Tumor-adjacent Normal
ADAMTS5	Tumor-adjacent Normal
LRRN4CL	Tumor-adjacent Normal
BICC1	Tumor-adjacent Normal
COL8A1	Tumor-adjacent Normal
SCG2	Tumor-adjacent Normal
SPON2	Tumor-adjacent Normal
DCN	Tumor-adjacent Normal
ACTA2	Tumor-adjacent Normal
PPL	Tumor-adjacent Normal
GAS7	Tumor-adjacent Normal
FGD5	Tumor-adjacent Normal
NUAK1	Tumor-adjacent Normal
ARHGAP23	Tumor-adjacent Normal
ATF3	Tumor-adjacent Normal
CRISPLD2	Tumor-adjacent Normal
TPST1	Tumor-adjacent Normal
SERPINA3	Tumor-adjacent Normal
COL6A2	Tumor-adjacent Normal
NUMBL	Tumor-adjacent Normal
SDPR	Tumor-adjacent Normal
GRASP	Tumor-adjacent Normal
CFHR1	Tumor-adjacent Normal
C1QTNF3	Tumor-adjacent Normal
AHI1	Tumor-adjacent Normal
PER1	Tumor-adjacent Normal
MLLT11	Tumor-adjacent Normal
ECM2	Tumor-adjacent Normal
JUNB	Tumor-adjacent Normal
PODN	Tumor-adjacent Normal
TMEM47	Tumor-adjacent Normal
LDLR	Tumor-adjacent Normal
TWIST2	Tumor-adjacent Normal
SLITRK3	Tumor-adjacent Normal
THSD7A	Tumor-adjacent Normal
GREM2	Tumor-adjacent Normal
CFH	Tumor-adjacent Normal
TLN1	Tumor-adjacent Normal
HBEGF	Tumor-adjacent Normal
ERG	Tumor-adjacent Normal
SLC7A2	Tumor-adjacent Normal
GAS1	Tumor-adjacent Normal
FOXF1	Tumor-adjacent Normal
JAM2	Tumor-adjacent Normal
LHFP	Tumor-adjacent Normal
OLFML3	Tumor-adjacent Normal
FRMD6	Tumor-adjacent Normal
COL6A1	Tumor-adjacent Normal
AKAP12	Tumor-adjacent Normal
EGR2	Tumor-adjacent Normal
MIR21	Tumor-adjacent Normal
VMP1	Tumor-adjacent Normal
NLGN4X	Tumor-adjacent Normal
MN1	Tumor-adjacent Normal
DDR2	Tumor-adjacent Normal
EDNRA	Tumor-adjacent Normal
TMEFF2	Tumor-adjacent Normal
COL1A2	Tumor-adjacent Normal
DBN1	Tumor-adjacent Normal
ISLR	Tumor-adjacent Normal
GATA2	Tumor-adjacent Normal
PAMR1	Tumor-adjacent Normal
FGFR1	Tumor-adjacent Normal
TNFAIP2	Tumor-adjacent Normal
IRS1	Tumor-adjacent Normal
DARC	Tumor-adjacent Normal
CAV1	Tumor-adjacent Normal
ELTD1	Tumor-adjacent Normal
PHLDA1	Tumor-adjacent Normal
EMCN	Tumor-adjacent Normal
IGDCC4	Tumor-adjacent Normal
RBMS1	Tumor-adjacent Normal
RNF213	Tumor-adjacent Normal
GEM	Tumor-adjacent Normal
ARHGEF10	Tumor-adjacent Normal
RUFY2	Tumor-adjacent Normal
PALMD	Tumor-adjacent Normal
PLN	Tumor-adjacent Normal
THY1	Tumor-adjacent Normal
SH3BP5	Tumor-adjacent Normal
EFEMP2	Tumor-adjacent Normal
PTPRS	Tumor-adjacent Normal
LGI1	Tumor-adjacent Normal
PRELP	Tumor-adjacent Normal
RUFY3	Tumor-adjacent Normal
TLL1	Tumor-adjacent Normal
FOXC1	Tumor-adjacent Normal
CDKN1C	Tumor-adjacent Normal
LARP6	Tumor-adjacent Normal
CYYR1	Tumor-adjacent Normal
TRIB2	Tumor-adjacent Normal
ZBTB16	Tumor-adjacent Normal
ZNF423	Tumor-adjacent Normal
AFF3	Tumor-adjacent Normal
RHOB	Tumor-adjacent Normal
CTSK	Tumor-adjacent Normal
EGR3	Tumor-adjacent Normal
OMD	Tumor-adjacent Normal
GPX3	Tumor-adjacent Normal
RTN1	Tumor-adjacent Normal
NRN1	Tumor-adjacent Normal
LEPR	Tumor-adjacent Normal
NR4A2	Tumor-adjacent Normal
S100A4	Tumor-adjacent Normal
FAM20C	Tumor-adjacent Normal
DLC1	Tumor-adjacent Normal
GYPC	Tumor-adjacent Normal
NFASC	Tumor-adjacent Normal
PRPH	Tumor-adjacent Normal
CAMTA1	Tumor-adjacent Normal
CHRM3	Tumor-adjacent Normal
TUBB3	Tumor-adjacent Normal
TCF4	Tumor-adjacent Normal
COX7A1	Tumor-adjacent Normal
MX2	Tumor-adjacent Normal
CRYAB	Tumor-adjacent Normal
PDE4B	Tumor-adjacent Normal
SLIT2	Tumor-adjacent Normal
SPARCL1	Tumor-adjacent Normal
IGSF10	Tumor-adjacent Normal
IFI16	Tumor-adjacent Normal
ABCA9	Tumor-adjacent Normal
KCNAB1	Tumor-adjacent Normal
SULF1	Tumor-adjacent Normal
CADM3	Tumor-adjacent Normal
GPC6	Tumor-adjacent Normal
IGFBP3	Tumor-adjacent Normal
FIGF	Tumor-adjacent Normal
MAFF	Tumor-adjacent Normal
SOCS3	Tumor-adjacent Normal
COL4A1	Tumor-adjacent Normal
XAF1	Tumor-adjacent Normal
LPHN2	Tumor-adjacent Normal
FILIP1L	Tumor-adjacent Normal
FBLN5	Tumor-adjacent Normal
C1QTNF7	Tumor-adjacent Normal
IL33	Tumor-adjacent Normal
LIFR	Tumor-adjacent Normal
PDZD2	Tumor-adjacent Normal
LAMB2	Tumor-adjacent Normal
HTRA3	Tumor-adjacent Normal
SPARC	Tumor-adjacent Normal
TUBB6	Tumor-adjacent Normal
SSPN	Tumor-adjacent Normal
FRAS1	Tumor-adjacent Normal
NR4A3	Tumor-adjacent Normal
SERPINE2	Tumor-adjacent Normal
FAM129A	Tumor-adjacent Normal
COL18A1	Tumor-adjacent Normal
NKX2-3	Tumor-adjacent Normal
PCDH7	Tumor-adjacent Normal
CCDC50	Tumor-adjacent Normal
VCAN	Tumor-adjacent Normal
DCLK1	Tumor-adjacent Normal
ITPR1	Tumor-adjacent Normal
SGK1	Tumor-adjacent Normal
INMT	Tumor-adjacent Normal
FHL5	Tumor-adjacent Normal
TSHZ2	Tumor-adjacent Normal
CAV2	Tumor-adjacent Normal
PCDH9	Tumor-adjacent Normal
HERC5	Tumor-adjacent Normal
FEZ1	Tumor-adjacent Normal
SERPINE1	Tumor-adjacent Normal
MYADM	Tumor-adjacent Normal
SP110	Tumor-adjacent Normal
ADAMTS4	Tumor-adjacent Normal
GUCY1B3	Tumor-adjacent Normal
BEX1	Tumor-adjacent Normal
TIMP2	Tumor-adjacent Normal
MYH10	Tumor-adjacent Normal
CXCR4	Tumor-adjacent Normal
CCL21	Tumor-adjacent Normal
RECK	Tumor-adjacent Normal
JAM3	Tumor-adjacent Normal
TSHZ3	Tumor-adjacent Normal
TUBA1A	Tumor-adjacent Normal
ELAVL4	Tumor-adjacent Normal
MX1	Tumor-adjacent Normal
IFI44	Tumor-adjacent Normal
NXN	Tumor-adjacent Normal
MAP4	Tumor-adjacent Normal
AOC3	Tumor-adjacent Normal
HELZ2	Tumor-adjacent Normal
MYOC	Tumor-adjacent Normal
B3GALNT1	Tumor-adjacent Normal
TAGLN	Tumor-adjacent Normal
HAND2	Tumor-adjacent Normal
MEDAG	Tumor-adjacent Normal
LRRC17	Tumor-adjacent Normal
MCAM	Tumor-adjacent Normal
S1PR3	Tumor-adjacent Normal
PTN	Tumor-adjacent Normal
PPFIBP1	Tumor-adjacent Normal
PDE1A	Tumor-adjacent Normal
FGF13	Tumor-adjacent Normal
RHOJ	Tumor-adjacent Normal
PRPF38B	Tumor-adjacent Normal
SDC2	Tumor-adjacent Normal
ITIH5	Tumor-adjacent Normal
SYT1	Tumor-adjacent Normal
IFIT1	Tumor-adjacent Normal
MEOX2	Tumor-adjacent Normal
ADARB1	Tumor-adjacent Normal
NAP1L5	Tumor-adjacent Normal
OSR2	Tumor-adjacent Normal
CDH13	Tumor-adjacent Normal
WWTR1	Tumor-adjacent Normal
COL1A1	Tumor-adjacent Normal
CES1P1	Tumor-adjacent Normal
CES1	Tumor-adjacent Normal
IFIT3	Tumor-adjacent Normal
NEXN	Tumor-adjacent Normal
PTRF	Tumor-adjacent Normal
TIMP1	Tumor-adjacent Normal
FOSB	Tumor-adjacent Normal
CFD	Tumor-adjacent Normal
FAM13C	Tumor-adjacent Normal
C16orf45	Tumor-adjacent Normal
OR51E2	Tumor-adjacent Normal
FMO2	Tumor-adjacent Normal
MXRA7	Tumor-adjacent Normal
MPDZ	Tumor-adjacent Normal
MAP2	Tumor-adjacent Normal
FXYD1	Tumor-adjacent Normal
DHX58	Tumor-adjacent Normal
GPRASP1	Tumor-adjacent Normal
RERG	Tumor-adjacent Normal
ZCCHC24	Tumor-adjacent Normal
CD109	Tumor-adjacent Normal
HBA1	Tumor-adjacent Normal
HBA2	Tumor-adjacent Normal
HMP19	Tumor-adjacent Normal
GUCY1A3	Tumor-adjacent Normal
GLI3	Tumor-adjacent Normal
RBPMS2	Tumor-adjacent Normal
MFAP4	Tumor-adjacent Normal
CXCL12	Tumor-adjacent Normal
DIP2C	Tumor-adjacent Normal
DNAJC6	Tumor-adjacent Normal
FRY	Tumor-adjacent Normal
MRAS	Tumor-adjacent Normal
PRICKLE2	Tumor-adjacent Normal
GHR	Tumor-adjacent Normal
TUBB2B	Tumor-adjacent Normal
CDH19	Tumor-adjacent Normal
OLFML2A	Tumor-adjacent Normal
WASF3	Tumor-adjacent Normal
CHRNA3	Tumor-adjacent Normal
NDRG4	Tumor-adjacent Normal
KLF7	Tumor-adjacent Normal
SPOCK1	Tumor-adjacent Normal
INHBB	Tumor-adjacent Normal
PEG3	Tumor-adjacent Normal
ACTG2	Tumor-adjacent Normal
EHD2	Tumor-adjacent Normal
PRKCDBP	Tumor-adjacent Normal
MEIS1	Tumor-adjacent Normal
TMEM255A	Tumor-adjacent Normal
AMOTL1	Tumor-adjacent Normal
SLC12A4	Tumor-adjacent Normal
TPM2	Tumor-adjacent Normal
ASPN	Tumor-adjacent Normal
HERC6	Tumor-adjacent Normal
PGM5	Tumor-adjacent Normal
TRIM22	Tumor-adjacent Normal
BHLHE41	Tumor-adjacent Normal
CDO1	Tumor-adjacent Normal
ANGPTL1	Tumor-adjacent Normal
RSPO2	Tumor-adjacent Normal
NAP1L3	Tumor-adjacent Normal
LIMCH1	Tumor-adjacent Normal
EFS	Tumor-adjacent Normal
IFI6	Tumor-adjacent Normal
GALNT15	Tumor-adjacent Normal
C20orf194	Tumor-adjacent Normal
PTGS2	Tumor-adjacent Normal
ITGA7	Tumor-adjacent Normal
SOBP	Tumor-adjacent Normal
AKAP2	Tumor-adjacent Normal
PALM2-AKAP2	Tumor-adjacent Normal
RASL12	Tumor-adjacent Normal
AHNAK2	Tumor-adjacent Normal
USP18	Tumor-adjacent Normal
GFRA1	Tumor-adjacent Normal
TSPYL5	Tumor-adjacent Normal
SMARCA1	Tumor-adjacent Normal
NEFL	Tumor-adjacent Normal
CHN1	Tumor-adjacent Normal
PTGDS	Tumor-adjacent Normal
PIRT	Tumor-adjacent Normal
SEMA3A	Tumor-adjacent Normal
ISG15	Tumor-adjacent Normal
IFI44L	Tumor-adjacent Normal
FABP4	Tumor-adjacent Normal
TSPAN4	Tumor-adjacent Normal
ANO6	Tumor-adjacent Normal
PARP9	Tumor-adjacent Normal
IL17RD	Tumor-adjacent Normal
FLNA	Tumor-adjacent Normal
ATP2B4	Tumor-adjacent Normal
SLC2A3	Tumor-adjacent Normal
C4A	Tumor-adjacent Normal
C4B	Tumor-adjacent Normal
KIAA0408	Tumor-adjacent Normal
SOGA3	Tumor-adjacent Normal
PPP1R12B	Tumor-adjacent Normal
MUC4	Tumor-adjacent Normal
ABCC9	Tumor-adjacent Normal
RAI2	Tumor-adjacent Normal
FGF7	Tumor-adjacent Normal
NRXN3	Tumor-adjacent Normal
LRRFIP1	Tumor-adjacent Normal
CYP1B1	Tumor-adjacent Normal
TMOD2	Tumor-adjacent Normal
CTSG	Tumor-adjacent Normal
NCAM1	Tumor-adjacent Normal
AGTR1	Tumor-adjacent Normal
EML1	Tumor-adjacent Normal
TCEAL7	Tumor-adjacent Normal
MYH11	Tumor-adjacent Normal
ZEB1	Tumor-adjacent Normal
PRDM8	Tumor-adjacent Normal
PALLD	Tumor-adjacent Normal
FZD7	Tumor-adjacent Normal
ZNF532	Tumor-adjacent Normal
HLF	Tumor-adjacent Normal
CLIP3	Tumor-adjacent Normal
RAB34	Tumor-adjacent Normal
SAMD9L	Tumor-adjacent Normal
OAS2	Tumor-adjacent Normal
RIMKLB	Tumor-adjacent Normal
SERPINF1	Tumor-adjacent Normal
PTBP2	Tumor-adjacent Normal
ROR2	Tumor-adjacent Normal
LPL	Tumor-adjacent Normal
CNTN1	Tumor-adjacent Normal
CCNL1	Tumor-adjacent Normal
SMIM10	Tumor-adjacent Normal
FERMT2	Tumor-adjacent Normal
AREG	Tumor-adjacent Normal
CALD1	Tumor-adjacent Normal
KATNAL1	Tumor-adjacent Normal
TRPC1	Tumor-adjacent Normal
RBPMS	Tumor-adjacent Normal
RUNX1T1	Tumor-adjacent Normal
RGS5	Tumor-adjacent Normal
SYNPO2	Tumor-adjacent Normal
SAA2-SAA4	Tumor-adjacent Normal
TNC	Tumor-adjacent Normal
MYL9	Tumor-adjacent Normal
DPYSL3	Tumor-adjacent Normal
PHOX2B	Tumor-adjacent Normal
DACT3	Tumor-adjacent Normal
VGLL3	Tumor-adjacent Normal
KCNN3	Tumor-adjacent Normal
SYNM	Tumor-adjacent Normal
HSPB8	Tumor-adjacent Normal
PDLIM4	Tumor-adjacent Normal
PHLDB2	Tumor-adjacent Normal
REEP1	Tumor-adjacent Normal
HBB	Tumor-adjacent Normal
OAS3	Tumor-adjacent Normal
MSRB3	Tumor-adjacent Normal
SGCD	Tumor-adjacent Normal
CLIP4	Tumor-adjacent Normal
ATP1A2	Tumor-adjacent Normal
TGFB1I1	Tumor-adjacent Normal
OLFML2B	Tumor-adjacent Normal
COL15A1	Tumor-adjacent Normal
PHF20L1	Tumor-adjacent Normal
PBX3	Tumor-adjacent Normal
NTM	Tumor-adjacent Normal
GPM6B	Tumor-adjacent Normal
BNC2	Tumor-adjacent Normal
FHL1	Tumor-adjacent Normal
MTCL1	Tumor-adjacent Normal
ADAMTSL3	Tumor-adjacent Normal
JAZF1	Tumor-adjacent Normal
SPP1	Tumor-adjacent Normal
MRVI1	Tumor-adjacent Normal
SAMD4A	Tumor-adjacent Normal
RBM24	Tumor-adjacent Normal
ZAK	Tumor-adjacent Normal
PLP1	Tumor-adjacent Normal
MYLK	Tumor-adjacent Normal
LSAMP	Tumor-adjacent Normal
SELM	Tumor-adjacent Normal
CYS1	Tumor-adjacent Normal
BCHE	Tumor-adjacent Normal
NT5DC3	Tumor-adjacent Normal
TCEAL2	Tumor-adjacent Normal
CASQ2	Tumor-adjacent Normal
MUC12	Tumor-adjacent Normal
MYOCD	Tumor-adjacent Normal
DTNA	Tumor-adjacent Normal
DNER	Tumor-adjacent Normal
PRDM6	Tumor-adjacent Normal
RASSF8	Tumor-adjacent Normal
STON1	Tumor-adjacent Normal
CNN1	Tumor-adjacent Normal
FIBIN	Tumor-adjacent Normal
SORBS1	Tumor-adjacent Normal
TSPAN18	Tumor-adjacent Normal
MAMDC2	Tumor-adjacent Normal
ADIPOQ	Tumor-adjacent Normal
NPR3	Tumor-adjacent Normal
TNS1	Tumor-adjacent Normal
G0S2	Tumor-adjacent Normal
NRXN1	Tumor-adjacent Normal
NBEA	Tumor-adjacent Normal
PDLIM3	Tumor-adjacent Normal
S100B	Tumor-adjacent Normal
WFDC1	Tumor-adjacent Normal
KCNH2	Tumor-adjacent Normal
IL8	Tumor-adjacent Normal
SPG20	Tumor-adjacent Normal
MRGPRF	Tumor-adjacent Normal
PRNP	Tumor-adjacent Normal
CPED1	Tumor-adjacent Normal
CXCL11	Tumor-adjacent Normal
LAMP3	Tumor-adjacent Normal
LIMS2	Tumor-adjacent Normal
DDX58	Tumor-adjacent Normal
GLDN	Tumor-adjacent Normal
KANK2	Tumor-adjacent Normal
DES	Tumor-adjacent Normal
GJC1	Tumor-adjacent Normal
CXCL1	Tumor-adjacent Normal
PLIN1	Tumor-adjacent Normal
SORBS2	Tumor-adjacent Normal
KCNMB1	Tumor-adjacent Normal
EPHA3	Tumor-adjacent Normal
CFL2	Tumor-adjacent Normal
FLNC	Tumor-adjacent Normal
ITGA5	Tumor-adjacent Normal
B3GNT7	Tumor-adjacent Normal
CCL20	Tumor-adjacent Normal
PLEKHO1	Tumor-adjacent Normal
TSPAN2	Tumor-adjacent Normal
MEIS2	Tumor-adjacent Normal
SAA1	Tumor-adjacent Normal
ARHGEF25	Tumor-adjacent Normal
TMEM200A	Tumor-adjacent Normal
THRB	Tumor-adjacent Normal
GPM6A	Tumor-adjacent Normal
BAG2	Tumor-adjacent Normal
PRAC1	Tumor-adjacent Normal
FILIP1	Tumor-adjacent Normal
CCL2	Tumor-adjacent Normal
LMOD1	Tumor-adjacent Normal
PI3	Tumor-adjacent Normal
FAM46B	Tumor-adjacent Normal
CPXM2	Tumor-adjacent Normal
ST3GAL4	Tumor-adjacent Normal
IQCJ-SCHIP1	Tumor-adjacent Normal
SCHIP1	Tumor-adjacent Normal
SNAP25	Tumor-adjacent Normal
PRKAA2	Tumor-adjacent Normal
SCNN1G	Tumor-adjacent Normal
CAP2	Tumor-adjacent Normal
CMPK2	Tumor-adjacent Normal
HSPB7	Tumor-adjacent Normal
LAYN	Tumor-adjacent Normal
DNAJB5	Tumor-adjacent Normal
HOXB13	Tumor-adjacent Normal
RSAD2	Tumor-adjacent Normal
FXYD6-FXYD2	Tumor-adjacent Normal
FXYD6	Tumor-adjacent Normal
FNDC1	Tumor-adjacent Normal
C21orf88	Tumor-adjacent Normal
SEPT6	Tumor-adjacent Normal
VCL	Tumor-adjacent Normal
LDB3	Tumor-adjacent Normal
LMO3	Tumor-adjacent Normal
MASP1	Tumor-adjacent Normal
PDZRN4	Tumor-adjacent Normal
SMTN	Tumor-adjacent Normal
AKR1C1	Tumor-adjacent Normal
THBS4	Tumor-adjacent Normal
NPTX1	Tumor-adjacent Normal
RAMP1	Tumor-adjacent Normal
POPDC2	Tumor-adjacent Normal
DUOX2	Tumor-adjacent Normal
CXCL13	Tumor-adjacent Normal
PCP4	Tumor-adjacent Normal
CCL19	Tumor-adjacent Normal
PENK	Tumor-adjacent Normal
INSL5	Tumor-adjacent Normal
SMPX	Tumor-adjacent Normal
FDCSP	Tumor-adjacent Normal
CEMIP	Tumor
CLDN1	Tumor
ETV4	Tumor
SLC6A6	Tumor
FOXQ1	Tumor
CDH3	Tumor
GTF2IRD1	Tumor
PPM1H	Tumor
TMEM206	Tumor
ASCL2	Tumor
TRIB3	Tumor
NFE2L3	Tumor
ENC1	Tumor
MTHFD1L	Tumor
NONO	Tumor
AHCY	Tumor
SLC7A5	Tumor
SLCO4A1	Tumor
ARMC10	Tumor
AJUBA	Tumor
XPOT	Tumor
DNAJC2	Tumor
NKRF	Tumor
TEX10	Tumor
CBFB	Tumor
ATP11A	Tumor
BYSL	Tumor
TGIF2	Tumor
HILPDA	Tumor
ADNP	Tumor
NOB1	Tumor
OSBPL3	Tumor
SNORA56	Tumor
DKC1	Tumor
POLR1B	Tumor
PUS7	Tumor
MZT1	Tumor
PDX1	Tumor
CSE1L	Tumor
KIAA1549	Tumor
SNTB1	Tumor
TEAD4	Tumor
MACC1	Tumor
CBX3	Tumor
NPM1	Tumor
PRPF4	Tumor
WDR77	Tumor
NIFK	Tumor
LMBR1	Tumor
TGFBI	Tumor
ZFAS1	Tumor
MRGBP	Tumor
TMEM161A	Tumor
NIT2	Tumor
S100A11	Tumor
SOX4	Tumor
MFSD12	Tumor
HEATR1	Tumor
PDCD2L	Tumor
NTMT1	Tumor
TNFRSF12A	Tumor
RFC3	Tumor
ZNF593	Tumor
JADE3	Tumor
NUFIP1	Tumor
NEBL	Tumor
CAD	Tumor
INHBA	Tumor
EXOSC5	Tumor
CKAP2	Tumor
DDX31	Tumor
MMP7	Tumor
GMPS	Tumor
ZDHHC9	Tumor
RAE1	Tumor
PRMT3	Tumor
WDR12	Tumor
RNF43	Tumor
MYC	Tumor
CMSS1	Tumor
TTYH3	Tumor
CSNK2A2	Tumor
DDX21	Tumor
WDR43	Tumor
TGDS	Tumor
MET	Tumor
SMYD3	Tumor
SLC39A10	Tumor
ACTL6A	Tumor
RIPK2	Tumor
LRP8	Tumor
CCT3	Tumor
C16orf13	Tumor
CCT6A	Tumor
NSUN5	Tumor
PAFAH1B3	Tumor
GTPBP4	Tumor
C10orf2	Tumor
TGIF1	Tumor
DCUN1D5	Tumor
DDX56	Tumor
DARS	Tumor
TTI1	Tumor
PHLDA1	Tumor
ATP6V1F	Tumor
POLR1D	Tumor
PNO1	Tumor
PPA1	Tumor
RPS14	Tumor
MRPL3	Tumor
GALK1	Tumor
CD3EAP	Tumor
CHCHD6	Tumor
PLXNA1	Tumor
TOP1MT	Tumor
NOL8	Tumor
NAT10	Tumor
TMEM41A	Tumor
CDK4	Tumor
WDR75	Tumor
RPGRIP1L	Tumor
ZC3HAV1L	Tumor
TESC	Tumor
TDGF1	Tumor
GEMIN5	Tumor
IMPDH1	Tumor
NOP58	Tumor
NAA25	Tumor
GTF3A	Tumor
RCL1	Tumor
ZNF146	Tumor
ZNF74	Tumor
DPEP1	Tumor
CD44	Tumor
ZC3H8	Tumor
C2	Tumor
CELSR1	Tumor
CBX4	Tumor
ZNF280C	Tumor
ACBD6	Tumor
PPAT	Tumor
GRAMD1A	Tumor
ANLN	Tumor
RBM28	Tumor
RLIM	Tumor
HSP90AB3P	Tumor
PFDN2	Tumor
TOMM34	Tumor
CKAP5	Tumor
TMEM132A	Tumor
PPRC1	Tumor
FXYD5	Tumor
CDK5RAP1	Tumor
PALB2	Tumor
RCN1	Tumor
CCND1	Tumor
UBA2	Tumor
PSMA7	Tumor
UTP18	Tumor
TMEM185B	Tumor
CIRH1A	Tumor
PDCD5	Tumor
FTSJ1	Tumor
NUDCD1	Tumor
ZPR1	Tumor
WDR3	Tumor
LRP11	Tumor
EPHB4	Tumor
RNASEH2A	Tumor
HSPH1	Tumor
PRIM2	Tumor
ASUN	Tumor
RUVBL1	Tumor
POLR1C	Tumor
FAM60A	Tumor
NR2C2AP	Tumor
DUSP14	Tumor
TRIM59	Tumor
IARS	Tumor
SHMT2	Tumor
GALNT6	Tumor
GNPDA1	Tumor
ZMYND19	Tumor
E2F6	Tumor
ANAPC1	Tumor
TPX2	Tumor
TCF3	Tumor
NELFCD	Tumor
NXT1	Tumor
WDR74	Tumor
TRPM2	Tumor
MRPL17	Tumor
EPHX4	Tumor
TRIP13	Tumor
DCAF13	Tumor
C2orf15	Tumor
MRPL30	Tumor
ATAD2	Tumor
NLE1	Tumor
SLC11A2	Tumor
MRPS17	Tumor
EBPL	Tumor
SKA3	Tumor
PPP1R35	Tumor
RRP9	Tumor
IPO5	Tumor
RNF114	Tumor
GDF15	Tumor
DIEXF	Tumor
MRPS23	Tumor
MMP11	Tumor
PDRG1	Tumor
MEST	Tumor
CMTM8	Tumor
TTC17	Tumor
TTLL4	Tumor
ATR	Tumor
SSBP1	Tumor
C12orf45	Tumor
OGFOD1	Tumor
ATIC	Tumor
CGREF1	Tumor
NOLC1	Tumor
TWISTNB	Tumor
DIS3	Tumor
ZBTB33	Tumor
XPO5	Tumor
B3GALT6	Tumor
ECT2	Tumor
TBL2	Tumor
UBE2C	Tumor
URB2	Tumor
TMEM123	Tumor
NOL6	Tumor
ARID3A	Tumor
PUS1	Tumor
GARS	Tumor
ABCE1	Tumor
SOX9	Tumor
RRS1	Tumor
BRAT1	Tumor
DACH1	Tumor
TXLNG	Tumor
RPP40	Tumor
TCF7	Tumor
EIF2S3	Tumor
SNRPE	Tumor
CDC25B	Tumor
TKT	Tumor
TAF1A	Tumor
SLC25A32	Tumor
RPL36	Tumor
ENOX2	Tumor
CDCA4	Tumor
ZP3	Tumor
PMAIP1	Tumor
ITGA2	Tumor
SHROOM4	Tumor
CENPP	Tumor
PHF19	Tumor
YDJC	Tumor
LYAR	Tumor
QSOX2	Tumor
C1orf109	Tumor
HSP90AB1	Tumor
ORC6	Tumor
BRIX1	Tumor
HEATR2	Tumor
BRCA2	Tumor
MEX3D	Tumor
CRNDE	Tumor
PRDX4	Tumor
SND1	Tumor
YTHDF1	Tumor
NOP2	Tumor
CCNB1IP1	Tumor
EIF3B	Tumor
WNT2	Tumor
RPUSD4	Tumor
ESM1	Tumor
C19orf48	Tumor
SNORD88C	Tumor
IPO7	Tumor
DUS4L	Tumor
SMARCC1	Tumor
HOMER1	Tumor
CHPF	Tumor
AUNIP	Tumor
XPO4	Tumor
TEX30	Tumor
RPF2	Tumor
NME1-NME2	Tumor
NME2	Tumor
TRMT1	Tumor
IL8	Tumor
NAT9	Tumor
METTL1	Tumor
ENOPH1	Tumor
UBE2S	Tumor
EXOSC7	Tumor
PSMD14	Tumor
NKD2	Tumor
MSX2	Tumor
TP53RK	Tumor
GRPEL2	Tumor
RUNX1	Tumor
DSCC1	Tumor
HAUS6	Tumor
DDX55	Tumor
NFXL1	Tumor
NANP	Tumor
RHBDF2	Tumor
GPR180	Tumor
POLR2D	Tumor
AZGP1	Tumor
ZNF200	Tumor
SF3B3	Tumor
EIF2S2	Tumor
ZNRF3	Tumor
UBE3D	Tumor
SULT2B1	Tumor
PAICS	Tumor
NUPL1	Tumor
PFDN4	Tumor
NMD3	Tumor
LSM5	Tumor
R3HDM1	Tumor
ASXL1	Tumor
DSN1	Tumor
C6orf48	Tumor
C12orf29	Tumor
PLAU	Tumor
DDX10	Tumor
PCID2	Tumor
IER5L	Tumor
UHRF1	Tumor
GPATCH2	Tumor
MIF	Tumor
CNPY3	Tumor
HSPD1	Tumor
YEATS4	Tumor
LAS1L	Tumor
ST7	Tumor
TMA16	Tumor
RAD18	Tumor
TCOF1	Tumor
NPRL3	Tumor
PTRH1	Tumor
TGS1	Tumor
SNORD19B	Tumor
GNL3	Tumor
NME1	Tumor
TTPAL	Tumor
CENPN	Tumor
TIMM50	Tumor
BID	Tumor
POLR1A	Tumor
SLC5A6	Tumor
SORD	Tumor
MTHFD2	Tumor
CCDC86	Tumor
AARS	Tumor
DIMT1	Tumor
PPAN	Tumor
EVA1A	Tumor
NIP7	Tumor
SNRPB	Tumor
ARNTL2	Tumor
BUB3	Tumor
PMEPA1	Tumor
COMT	Tumor
BCL2L12	Tumor
PPAN-P2RY11	Tumor
AURKAPS1	Tumor
RAB3GAP2	Tumor
SPIN4	Tumor
E2F5	Tumor
NUP205	Tumor
PHF14	Tumor
PYCR1	Tumor
POMP	Tumor
NAA20	Tumor
MSI2	Tumor
FTSJ2	Tumor
ACTR5	Tumor
PRKDC	Tumor
TRAP1	Tumor
PSMG4	Tumor
DCTD	Tumor
EXOSC3	Tumor
CKAP2L	Tumor
NCAPG2	Tumor
NCAPD3	Tumor
GGCT	Tumor
DBF4	Tumor
CEBPB	Tumor
CD46	Tumor
AXIN2	Tumor
NDE1	Tumor
POLR3E	Tumor
CCDC113	Tumor
SLC3A2	Tumor
C2CD4A	Tumor
MTERFD1	Tumor
TRIM27	Tumor
AZIN1	Tumor
PAXIP1	Tumor
SLC35C2	Tumor
RRP1	Tumor
MCM3	Tumor
SNRPF	Tumor
PSAT1	Tumor
ERCC6L	Tumor
PDCD2	Tumor
PROSER1	Tumor
PAM16	Tumor
RRP12	Tumor
RNASEH2B	Tumor
EXOSC8	Tumor
TBC1D16	Tumor
DNTTIP1	Tumor
CORO7-PAM16	Tumor
MBTPS2	Tumor
PABPC1	Tumor
C17orf96	Tumor
CEP72	Tumor
CPSF4	Tumor
HS2ST1	Tumor
DDX27	Tumor
COL11A1	Tumor
SYNCRIP	Tumor
MSL3P1	Tumor
GLA	Tumor
PLAGL2	Tumor
SDCCAG3	Tumor
SLC7A6	Tumor
NDRG3	Tumor
EFCAB11	Tumor
CXCL3	Tumor
PHF20	Tumor
PRPS1	Tumor
NOP16	Tumor
GLRX3	Tumor
TMEM97	Tumor
NAA16	Tumor
MEX3A	Tumor
CKS2	Tumor
SCML1	Tumor
HM13	Tumor
RCBTB1	Tumor
GRIN2D	Tumor
WDYHV1	Tumor
KIAA1430	Tumor
CHI3L1	Tumor
SMOX	Tumor
NUP35	Tumor
ZNF239	Tumor
RUVBL2	Tumor
SRM	Tumor
EXOSC2	Tumor
FIGNL1	Tumor
NEK2	Tumor
DIAPH3	Tumor
UFM1	Tumor
NMB	Tumor
TM9SF4	Tumor
RAD54B	Tumor
RPL35A	Tumor
SIGMAR1	Tumor
PCMTD2	Tumor
SIM2	Tumor
USP6NL	Tumor
SPDL1	Tumor
GPN3	Tumor
ILF3	Tumor
RACGAP1	Tumor
RFWD3	Tumor
ADRM1	Tumor
DLGAP4	Tumor
DBF4B	Tumor
PATZ1	Tumor
LRRC8E	Tumor
MMS22L	Tumor
CHD7	Tumor
GCSH	Tumor
URI1	Tumor
TRIM28	Tumor
POLB	Tumor
BOP1	Tumor
MYBL2	Tumor
ECE2	Tumor
BZW2	Tumor
C4orf46	Tumor
MCM7	Tumor
MMP3	Tumor
TRIM29	Tumor
C5orf34	Tumor
MAD2L2	Tumor
RAN	Tumor
CTPS2	Tumor
GEMIN6	Tumor
VSNL1	Tumor
POLA1	Tumor
CNN2	Tumor
CCT5	Tumor
PCNXL2	Tumor
YARS2	Tumor
CCT2	Tumor
CSNK1E	Tumor
GTF2F2	Tumor
NHP2	Tumor
NUP155	Tumor
DNMT1	Tumor
PRMT1	Tumor
KIF18A	Tumor
PIBF1	Tumor
TMEM9	Tumor
NUP37	Tumor
KRT23	Tumor
WDR46	Tumor
MOCS3	Tumor
TDP1	Tumor
AGTRAP	Tumor
IRAK1	Tumor
TMEM243	Tumor
UBE2F-SCLY	Tumor
SLC7A1	Tumor
NUDT1	Tumor
CEP55	Tumor
LSM8	Tumor
RRP15	Tumor
CTHRC1	Tumor
PPIL1	Tumor
RSL1D1	Tumor
LDLRAD3	Tumor
CCDC34	Tumor
SPNS2	Tumor
MRE11A	Tumor
CDK1	Tumor
PTPLAD1	Tumor
EIF5A2	Tumor
RFC4	Tumor
EGFL6	Tumor
CENPH	Tumor
EEF1E1	Tumor
LSM14B	Tumor
CTNNBL1	Tumor
RTKN	Tumor
UCHL3	Tumor
ANGEL1	Tumor
GPALPP1	Tumor
GRHL1	Tumor
ANXA9	Tumor
POLD2	Tumor
SLC22A3	Tumor
EXOSC4	Tumor
MORC4	Tumor
PLEKHG4	Tumor
DPY19L1	Tumor
KPNA2	Tumor
RSRC1	Tumor
UBE2T	Tumor
SH3BP4	Tumor
NEK6	Tumor
CEP41	Tumor
NUP62CL	Tumor
GPR56	Tumor
AURKA	Tumor
C3orf17	Tumor
KIF20A	Tumor
ABCC1	Tumor
NAA15	Tumor
CCDC85B	Tumor
FABP6	Tumor
KIF14	Tumor
TCFL5	Tumor
CMTM7	Tumor
TPD52L2	Tumor
MTBP	Tumor
GPSM2	Tumor
TIMM8A	Tumor
CTSH	Tumor
SCD	Tumor
C11orf82	Tumor
TRMT112	Tumor
FAM89A	Tumor
KIAA0020	Tumor
E2F3	Tumor
FBXO5	Tumor
NAP1L1	Tumor
SLC25A15	Tumor
TROAP	Tumor
IRAK2	Tumor
TMEM237	Tumor
CBX2	Tumor
AEN	Tumor
PGAM5	Tumor
FGFRL1	Tumor
GPT2	Tumor
MCM8	Tumor
SLC12A8	Tumor
MAGOHB	Tumor
EEPD1	Tumor
GLO1	Tumor
ASNS	Tumor
MSH6	Tumor
BUB1	Tumor
NOP56	Tumor
SNORD110	Tumor
SNORD86	Tumor
SNORD57	Tumor
MIR1292	Tumor
THOC3	Tumor
NOC3L	Tumor
ZNF697	Tumor
INTS6	Tumor
LZTS3	Tumor
BTF3L4	Tumor
KIAA1524	Tumor
CDK5	Tumor
TTF2	Tumor
CCNE1	Tumor
CENPL	Tumor
MCM10	Tumor
EMD	Tumor
TOP2A	Tumor
GRINA	Tumor
FAM122B	Tumor
G3BP1	Tumor
FANCB	Tumor
CDCA7	Tumor
CPNE1	Tumor
PRIM1	Tumor
IFRD2	Tumor
ACTL10	Tumor
TIMP1	Tumor
LMNB2	Tumor
ACSL6	Tumor
MAD2L1	Tumor
CXXC5	Tumor
ANKRD16	Tumor
CCNF	Tumor
NUPL2	Tumor
IMMP2L	Tumor
TIMELESS	Tumor
POC1B	Tumor
SRPRB	Tumor
TAMM41	Tumor
CDC6	Tumor
KIF4A	Tumor
LEPRE1	Tumor
FAM91A1	Tumor
MARS2	Tumor
IFITM3	Tumor
JPH1	Tumor
GART	Tumor
PAQR4	Tumor
UGGT2	Tumor
CXCL1	Tumor
CHEK1	Tumor
E2F7	Tumor
ETS2	Tumor
POFUT1	Tumor
MIR4647	Tumor
SLC35B2	Tumor
CKS1B	Tumor
PRICKLE4	Tumor
MARS	Tumor
CHCHD7	Tumor
UBE2I	Tumor
CLPB	Tumor
CENPA	Tumor
PRR11	Tumor
SLC7A11	Tumor
GINS1	Tumor
C9orf16	Tumor
NOP14	Tumor
BORA	Tumor
SNHG1	Tumor
SNORD22	Tumor
SNORD25	Tumor
SNORD26	Tumor
SNORD27	Tumor
SNORD28	Tumor
NUF2	Tumor
UTP15	Tumor
N6AMT2	Tumor
HPS3	Tumor
PLOD3	Tumor
ZNF511	Tumor
DNAJC10	Tumor
NARS2	Tumor
TSR1	Tumor
SAPCD2	Tumor
TRMT6	Tumor
GTSE1	Tumor
RPS15A	Tumor
LGR5	Tumor
TNFRSF10B	Tumor
VARS	Tumor
SGOL2	Tumor
NPM3	Tumor
ZNF273	Tumor
NT5DC2	Tumor
OLA1	Tumor
TSEN15	Tumor
GPR89B	Tumor
HELLS	Tumor
EZH2	Tumor
RAC1	Tumor
PKMYT1	Tumor
DNAH14	Tumor
SNX8	Tumor
DTYMK	Tumor
EXO1	Tumor
POLR1E	Tumor
EARS2	Tumor
C7orf50	Tumor
GPATCH4	Tumor
ORC3	Tumor
RANGAP1	Tumor
ORC5	Tumor
PTP4A3	Tumor
ANXA3	Tumor
LTV1	Tumor
COL1A1	Tumor
SPRY4	Tumor
TIGD2	Tumor
IMPDH2	Tumor
SHCBP1	Tumor
SUV39H1	Tumor
POP1	Tumor
LOXL2	Tumor
MTFR2	Tumor
DUS3L	Tumor
PARPBP	Tumor
LY6G6D	Tumor
TRAF5	Tumor
DUSP4	Tumor
BIRC5	Tumor
C6orf223	Tumor
ST3GAL2	Tumor
MSH2	Tumor
SPC25	Tumor
KIF21B	Tumor
RHEB	Tumor
UNC5CL	Tumor
FANCI	Tumor
DPP7	Tumor
PRPF6	Tumor
SLC29A1	Tumor
HAUS7	Tumor
STMN1	Tumor
ZNF367	Tumor
KIF2C	Tumor
RIOK1	Tumor
MSANTD3	Tumor
NUSAP1	Tumor
RAB15	Tumor
PLEKHA8P1	Tumor
THNSL1	Tumor
DTD1	Tumor
STIL	Tumor
GINS3	Tumor
FAM72A	Tumor
FAM72B	Tumor
FAM72C	Tumor
FAM72D	Tumor
RNF183	Tumor
DPCD	Tumor
KDELC1	Tumor
ACSL4	Tumor
PABPC4	Tumor
BRCA1	Tumor
FAM92A1	Tumor
IL1RAP	Tumor
NUP62	Tumor
MCM2	Tumor
MTHFD1	Tumor
LAMP2	Tumor
SMC4	Tumor
RPL28	Tumor
LYRM4	Tumor
E2F1	Tumor
RP11-474D1.3	Tumor
MND1	Tumor
CHD6	Tumor
PROX1	Tumor
C22orf29	Tumor
EEF2	Tumor
CCNB1	Tumor
MCM6	Tumor
CDC25C	Tumor
SH2D2A	Tumor
DGAT2	Tumor
SPIN3	Tumor
KLHL7	Tumor
ALDH4A1	Tumor
CDCA5	Tumor
CENPW	Tumor
NKD1	Tumor
ASPM	Tumor
RPL7L1	Tumor
PSMG1	Tumor
RFC2	Tumor
ODC1	Tumor
CDCA3	Tumor
RCC1	Tumor
WISP1	Tumor
SRPX2	Tumor
ADK	Tumor
CCDC138	Tumor
PITX1	Tumor
MRTO4	Tumor
DRAM1	Tumor
TMEM63A	Tumor
SLC1A5	Tumor
PALD1	Tumor
SHISA2	Tumor
FJX1	Tumor
HJURP	Tumor
AGT	Tumor
ASAP1	Tumor
SRPK1	Tumor
RANBP1	Tumor
PNPT1	Tumor
SLC12A2	Tumor
DESI1	Tumor
MFAP2	Tumor
RAD51AP1	Tumor
HMGA1	Tumor
CLDN2	Tumor
NCAPH	Tumor
GDPD5	Tumor
DTL	Tumor
TSPAN5	Tumor
HES6	Tumor
CHEK2	Tumor
CCNJ	Tumor
MMP1	Tumor
DNA2	Tumor
KIF4B	Tumor
TFDP1	Tumor
LIG1	Tumor
ZFP69B	Tumor
CTPS1	Tumor
MTL5	Tumor
RFC5	Tumor
MCM4	Tumor
FKBP10	Tumor
HIST3H2A	Tumor
SQLE	Tumor
ANP32E	Tumor
FAM111B	Tumor
RNF24	Tumor
MCFD2	Tumor
PCNA	Tumor
SERPINH1	Tumor
SNORA17	Tumor
SNORA43	Tumor
MELK	Tumor
SKIL	Tumor
EIF4EBP1	Tumor
PLEKHS1	Tumor
CENPF	Tumor
STC2	Tumor
HDGF	Tumor
DDX39A	Tumor
XRN2	Tumor
AGO2	Tumor
CHTF18	Tumor
MPP6	Tumor
RECQL4	Tumor
SLC39A6	Tumor
COA1	Tumor
DEF8	Tumor
STIP1	Tumor
KIFC1	Tumor
VEGFA	Tumor
RAD1	Tumor
GYLTL1B	Tumor
HMMR	Tumor
RRM2	Tumor
B9D1	Tumor
ASB9	Tumor
PTTG1	Tumor
KCNE3	Tumor
SSX2IP	Tumor
ANGPT2	Tumor
PRPS2	Tumor
RGS16	Tumor
ICA1	Tumor
ASF1B	Tumor
PRC1	Tumor
ESPL1	Tumor
EPHB3	Tumor
SH3PXD2B	Tumor
CDT1	Tumor
FAM57A	Tumor
KIF23	Tumor
DUSP2	Tumor
PLK1	Tumor
HENMT1	Tumor
RPS25	Tumor
CDC45	Tumor
TMPRSS3	Tumor
GINS4	Tumor
PLS3	Tumor
LPCAT1	Tumor
PTDSS1	Tumor
TNFRSF6B	Tumor
FERMT1	Tumor
MYL6B	Tumor
IFT22	Tumor
FAP	Tumor
XKRX	Tumor
SMC2	Tumor
LIF	Tumor
DLEU2L	Tumor
DLEU2	Tumor
PTBP3	Tumor
WNT3	Tumor
ADAM12	Tumor
FAM64A	Tumor
COL12A1	Tumor
EIF2AK1	Tumor
CALU	Tumor
RTEL1-TNFRSF6B	Tumor
RRM1	Tumor
COL5A2	Tumor
SLC1A4	Tumor
FOXRED2	Tumor
PPT1	Tumor
CYP39A1	Tumor
APOC4	Tumor
APOC4-APOC2	Tumor
KNSTRN	Tumor
MMP14	Tumor
CCDC167	Tumor
WDR4	Tumor
CTSV	Tumor
FOXM1	Tumor
BUB1B	Tumor
TNS4	Tumor
YAE1D1	Tumor
TLCD1	Tumor
TACSTD2	Tumor
GZMB	Tumor
DEPDC1B	Tumor
EBNA1BP2	Tumor
RTKN2	Tumor
C8orf59	Tumor
DDIT4	Tumor
PTK7	Tumor
CDCA8	Tumor
CDKN2A	Tumor
S100A2	Tumor
UBD	Tumor
HECW2	Tumor
RPL22L1	Tumor
CDKN3	Tumor
NUP210	Tumor
DIO2	Tumor
RPL37A	Tumor
COL7A1	Tumor
SNX10	Tumor
GRB7	Tumor
KCNQ1	Tumor
CLCN5	Tumor
LACTB2	Tumor
APLF	Tumor
BLM	Tumor
C2orf70	Tumor
DHCR7	Tumor
ARHGEF39	Tumor
CYP2S1	Tumor
KCTD14	Tumor
LEF1	Tumor
CENPE	Tumor
F2RL2	Tumor
APMAP	Tumor
ZWILCH	Tumor
NDUFC2-KCTD14	Tumor
SERPINB5	Tumor
EPHB2	Tumor
OTUB2	Tumor
PHKA1	Tumor
ORAI2	Tumor
IQGAP3	Tumor
KLK10	Tumor
CLCN4	Tumor
GPR143	Tumor
TTK	Tumor
WNT5A	Tumor
SYT7	Tumor
POLA2	Tumor
KIAA0226L	Tumor
PODXL	Tumor
PEMT	Tumor
ZAK	Tumor
FAM150A	Tumor
ABI2	Tumor
FOXA2	Tumor
FZD3	Tumor
SP6	Tumor
SFXN3	Tumor
PDPN	Tumor
CCL24	Tumor
CCNA2	Tumor
RANBP17	Tumor
FGFR4	Tumor
FADS1	Tumor
MIR1908	Tumor
SLC38A10	Tumor
CAPN10	Tumor
FEN1	Tumor
CAMTA1	Tumor
CXCL2	Tumor
DLGAP5	Tumor
LY6E	Tumor
STRA6	Tumor
CEL	Tumor
NDUFAF7	Tumor
COL4A1	Tumor
MKI67	Tumor
SLC27A5	Tumor
NR0B2	Tumor
SNORD5	Tumor
TAF1D	Tumor
MIR1304	Tumor
SNORA18	Tumor
SNORA32	Tumor
SNORA1	Tumor
SNORA40	Tumor
SNORA8	Tumor
FKBP9	Tumor
SLC35E4	Tumor
APOC2	Tumor
TCTN1	Tumor
STC1	Tumor
POLE2	Tumor
CA9	Tumor
LAPTM4B	Tumor
TBXAS1	Tumor
CASC5	Tumor
SP5	Tumor
TUBB	Tumor
BHLHE40	Tumor
ERO1L	Tumor
TRIP6	Tumor
BGN	Tumor
HTR1D	Tumor
PJA1	Tumor
EPHA1	Tumor
FUT8	Tumor
CACNA1D	Tumor
GGH	Tumor
GINS2	Tumor
ADA	Tumor
LIPG	Tumor
COL10A1	Tumor
MAGED2	Tumor
MMP12	Tumor
CFB	Tumor
CDC20	Tumor
SLC35D3	Tumor
RIPPLY3	Tumor
MZT2B	Tumor
KIF11	Tumor
FANCD2	Tumor
KLF7	Tumor
IFITM2	Tumor
MSX1	Tumor
AURKB	Tumor
PLEKHB1	Tumor
CDC25A	Tumor
WDR35	Tumor
CADPS	Tumor
ELOVL5	Tumor
NCAPD2	Tumor
COL5A1	Tumor
ASPHD1	Tumor
KCNN4	Tumor
KDELR3	Tumor
TWIST1	Tumor
RP11-93B14.5	Tumor
KIF15	Tumor
IL20RA	Tumor
EDNRA	Tumor
QPCT	Tumor
TGM2	Tumor
HS6ST2	Tumor
RNF145	Tumor
SERPINE1	Tumor
PROCR	Tumor
CDCA2	Tumor
OLR1	Tumor
TMEM158	Tumor
CST1	Tumor
MYEOV	Tumor
EDAR	Tumor
NOD2	Tumor
MMP10	Tumor
TNFSF11	Tumor
MTG2	Tumor
APCDD1	Tumor
HOXB8	Tumor
HAGHL	Tumor
ZNF469	Tumor
ITGB8	Tumor
PHGDH	Tumor
CTTNBP2	Tumor
PBK	Tumor
TUBB3	Tumor
REEP6	Tumor
OLFML2B	Tumor
FKBP11	Tumor
KRT7	Tumor
BMP4	Tumor
TSTA3	Tumor
KRT6B	Tumor
COL9A3	Tumor
SLC17A9	Tumor
OIP5	Tumor
BMP7	Tumor
DUSP10	Tumor
CXCL5	Tumor
CENPK	Tumor
NCAPG	Tumor
KLK6	Tumor
FOSL1	Tumor
FARP1	Tumor
PABPC1L	Tumor
ESCO2	Tumor
DHFR	Tumor
FGGY	Tumor
ZNF503	Tumor
FAM83D	Tumor
S100P	Tumor
LCN2	Tumor
THY1	Tumor
GNG4	Tumor
NDC80	Tumor
SPON2	Tumor
ANO6	Tumor
PVRL4	Tumor
GOLT1A	Tumor
NOX4	Tumor
EFNA3	Tumor
CXCL6	Tumor
MIR17HG	Tumor
MIR19B1	Tumor
MIR18A	Tumor
MIR92A1	Tumor
MIR17	Tumor
MIR19A	Tumor
MIR20A	Tumor
AMOT	Tumor
PDP1	Tumor
GRB10	Tumor
LRRC34	Tumor
FCGR3A	Tumor
ERP27	Tumor
TPD52L1	Tumor
SNX5	Tumor
CDH11	Tumor
PCSK9	Tumor
SLCO1B3	Tumor
PTPRO	Tumor
NCOA7	Tumor
KIAA0101	Tumor
ROBO2	Tumor
LMCD1	Tumor
HOXA11	Tumor
SLC2A1	Tumor
SFTA2	Tumor
HPDL	Tumor
RTEL1	Tumor
PLCB4	Tumor
MYOM3	Tumor
MMP9	Tumor
SLC5A1	Tumor
SPAG4	Tumor
RAB7L1	Tumor
SULF1	Tumor
SNORA81	Tumor
SNORD2	Tumor
EIF4A2	Tumor
SNORA4	Tumor
SNORA63	Tumor
TTC9	Tumor
SPARC	Tumor
SLC6A14	Tumor
AQP9	Tumor
SLC38A5	Tumor
ONECUT2	Tumor
SLC2A12	Tumor
MANEAL	Tumor
TDO2	Tumor
DNAH2	Tumor
CELP	Tumor
SPP1	Tumor
S100A9	Tumor
ARG2	Tumor
COCH	Tumor
KYNU	Tumor
EREG	Tumor
ADAMTS4	Tumor
GPX2	Tumor
IL1A	Tumor
TLR2	Tumor
SESN1	Tumor
KAL1	Tumor
GRM8	Tumor
TCN1	Tumor
ABCC2	Tumor
SYNE4	Tumor
BATF	Tumor
RBP1	Tumor
COL1A2	Tumor
LEMD1	Tumor
COL8A1	Tumor
SLC6A20	Tumor
COMP	Tumor
THBS2	Tumor
PDZK1IP1	Tumor
VCAN	Tumor
CYP2W1	Tumor
NMU	Tumor
CXCL11	Tumor
MME	Tumor
SKAP1	Tumor
SCRN1	Tumor
ALCAM	Tumor
PACSIN3	Tumor
SUSD3	Tumor
OXGR1	Tumor
SULT1C2	Tumor
CFI	Tumor
FAM3B	Tumor
QPRT	Tumor
LGR6	Tumor
UCA1	Tumor
TNFRSF11B	Tumor
FREM2	Tumor
IL13RA2	Tumor
DUSP27	Tumor
REG1A	Tumor
CYP4X1	Tumor
STMN3	Tumor
ODAM	Tumor
SFRP4	Tumor
DEFA6	Tumor
FOXD1	Tumor
FCGR1C	Tumor
FCGR1B	Tumor
NOTUM	Tumor
DSC3	Tumor
RNF182	Tumor
PITX2	Tumor
TREM2	Tumor
INHBB	Tumor
CCL3	Tumor
COL3A1	Tumor
REG3A	Tumor
IGF2BP3	Tumor
APOC1	Tumor
IL1RN	Tumor
EPHB1	Tumor
TNFAIP6	Tumor
IL1B	Tumor
ITGBL1	Tumor
CKMT2	Tumor
CXCL9	Tumor
ZIC2	Tumor
PLCB1	Tumor
DMKN	Tumor
GRP	Tumor
PPP2R2C	Tumor
SELE	Tumor
CXCL10	Tumor
PRSS33	Tumor
DAPL1	Tumor
DUOXA2	Tumor
AREG	Tumor
CCL20	Tumor
IDO1	Tumor
NPTX2	Tumor
BAMBI	Tumor
FNDC1	Tumor
PPBP	Tumor
REG1B	Tumor
LYZ	Tumor
DEFA5	Tumor
PSPH	Tumor
IGHG3	Tumor
IGHV4-31	Tumor
IGHG2	Tumor
